XXXXXXXXXXXXXXXXXXXXXXXXXXXXXXXXXXXXXXXXXXXXXXXXXXXXXXXXXXXXXXXXXXXXXXXXXXXXXXXXXXXXXXXXXXXXXXXXXXXXXXXXXXXXXXXXXXXXXXXXXXXXXXXXXXXXXXXXXXXXXXXXXXXXXXXXXXXXXXXXXXXXXXXXXXXXXXXXXXXXXXXXXXXXXXXXXXXXXXXXXXXXXXXXXXXXXXXXXXXXXXXXXXXXXXXXXXXXXXXXXXXXXXXXXXXXXXXXXXXXXXXXXXXXXXXXXXXXXXXXXXXXXXXXXXXXXXXXXXXXXXXXXXXXXXXXXXXXXXXXXXXXXXXXXXXXXXXXXXXXXXXXXXXXXXXXXXXXXXXXXXXXXXXXXXXXXXXXXXXXXXXXXXXXXXXXXXXXXXXXXXXXXXXXXXXXXXXXXXXXXXXXXXXXXXXXXXXXXXXXXXXXXXXXXXXXXXXXXXXXXXXXXXXXXXXXXXXXXXXXXXXXXXXXXXXXXXXXXXXXXXXXXXXXXXXX
X..............................................................................................................................................................................................................................................................................................................................................................................................................................................................................................................................X
X..............................................................................................................................................................................................................................................................................................................................................................................................................................................................................................................................X
X..............................................................................................................................................................................................................................................................................................................................................................................................................................................................................................................................X
X..............................................................................................................................................................................................................................................................................................................................................................................................................................................................................................................................X
X..............................................................................................................................................................................................................................................................................................................................................................................................................................................................................................................................X
X..............................................................................................................................................................................................................................................................................................................................................................................................................................................................................................................................X
X...........................................................................................................................................................................................C..................................................................................................................................................................................................................................................................................................................................X
X....................................................................................................................................................................................................................................................................................C.........................................................................................................................................................................................................................................X
X..................................................................................................................................................................................................................................................................................................................................................................................................................................................................G...........................................................X
X..............................................................................................................................................................................................................................................................................................................................................................................................................................................................g...G...........................................................X
X..................................................................................................................................................................................................................................................................................................................................................................................................................................................................G...........................................................X
X.........................................................................................................................................................................................E........................................................................................................................................................................................................................................................................G...........................................................X
X...............................................................................................................................................................................................................#########..........................................................#########........##########............................................................................................................................#######..................G...........................................................X
X...............................................................................................................................................................................................................#########..........................................................#########........##########............................................................................................................................#######..................G...........................................................X
X................................................#####................................................................................................................................###################.......#########..........................................................#########........##########.........................................................................................................................##########..................G...........................................................X
X................................................#####................................................................................................................................###################..............................................................................................................................................................................................................................##########..................G...........................................................X
X................................................#####................................................................................................................................###################..............................................C............................................................................................................................................................................#############..................G...........................................................X
X...................................................................................................................................................................................................................................................................................................................................................................................................................................#############..................G...........................................................X
X................................................................................................................................................................................................................................................................................................................................................................................................................................################..................G...........................................................X
X................................................................................................................................................................................................................................................................................................................................................................................................................................################..................G...........................................................X
X.......................................................................................................................................................................................................................................................................................................................###....###........................###....###..........................................................###################..................G...........................................................X
X..............................#####..........############.............................C......................................................C.................................#######.............................................#####.......#####........#####......................................................###....###........................###....###...........................##########.....................###################..................G...........................................................X
X..............................#####..........############......................................................................................................................#######.............................................#####.......#####........#####...................................................######....######..................######....######........................##########..................######################..................G...........................................................X
X..............................#####..........############......................................................................................................................#######.............................................#####.......#####........#####...................................................######....######..................######....######........................##########..................######################..................G...........................................................X
X.................................................................................................................................................................................................................................................................................................................#########....#########............#########....#########..............................................#########################..................G...........................................................X
X.................................................................................................................................................................................................................................................E.........................................E.....................#########....#########.....E......#########....#########..............................................#########################................#####.........................................................X
X..............................................................................................................................................................................................................................................................................................................############....############......############....############........................................############################................#####.........................................................X
X..............................................................................................................................................................................................................................................................................................................############....############......############....############........................................############################................#####.........................................................X
######################################################################################################################################################............###################################...............#########################################################################################################################################....##############################################################################################################################################################X
======================================================================================================================================================............===================================...............=========================================================================================================================================....==============================================================================================================================================================X
======================================================================================================================================================............===================================...............=========================================================================================================================================....==============================================================================================================================================================X
======================================================================================================================================================............===================================...............=========================================================================================================================================....==============================================================================================================================================================X
======================================================================================================================================================............===================================...............=========================================================================================================================================....==============================================================================================================================================================X
======================================================================================================================================================............===================================...............=========================================================================================================================================....==============================================================================================================================================================X
XXXXXXXXXXXXXXXXXXXXXXXXXXXXXXXXXXXXXXXXXXXXXXXXXXXXXXXXXXXXXXXXXXXXXXXXXXXXXXXXXXXXXXXXXXXXXXXXXXXXXXXXXXXXXXXXXXXXXXXXXXXXXXXXXXXXXXXXXXXXXXXXXXXXXXXXXXXXXXXXXXXXXXXXXXXXXXXXXXXXXXXXXXXXXXXXXXXXXXXXXXXXXXXXXXXXXXXXXXXXXXXXXXXXXXXXXXXXXXXXXXXXXXXXXXXXXXXXXXXXXXXXXXXXXXXXXXXXXXXXXXXXXXXXXXXXXXXXXXXXXXXXXXXXXXXXXXXXXXXXXXXXXXXXXXXXXXXXXXXXXXXXXXXXXXXXXXXXXXXXXXXXXXXXXXXXXXXXXXXXXXXXXXXXXXXXXXXXXXXXXXXXXXXXXXXXXXXXXXXXXXXXXXXXXXXXXXXXXXXXXXXXXXXXXXXXXXXXXXXXXXXXXXXXXXXXXXXXXXXXXXXXXXXXXXXXXXXXXXXXXXXXXXXXXXXX
