XXXXXXXXXXXXXXXXXXXXXXXXXXXXXXXXXXXXXXXXXXXXXXXXXXXXXXXXXXXXXXXXXXXXXXXXXXXXXXXXXXXXXXXXXXXXXXXXXXXXXXXXXXXXXXXXXXXXXXXXXXXXXXXXXXXXXXXXXXXXXXXXXXXXXXXXXXXXXXXXXXXXXXXXXXXXXXXXXXXXXXXXXXXXXXXXXXXXXXXXXXXXXXXXXXXXXXXXXXXXXXXXXXXXXXXXXXXXXXXXXXXXXXXXXXXXXXXXXXXXXXXXXXXXXXXXXXXXXXXXXXXXXXXXXXXXXXXXXXXXXXXXXXXXXXXXXXXXXXXXXXXXXXXXXXXXXXXXXXXXXXXXXXXXXXXXXXXXXXXXXXXXXXXXXXXXXXXXXXXXXXXXXXXXXXXXXXXXXXXXXXXXXXXXXXXXXXXXXXXXXXXXXXXXXXXXXXXXXXXXXXXXXXXXXXXXXXXXXXXXXXXXXXXXXXXXXXXXXXXXXXXXXXXXXXXXXXXXXXXXXXXXXXXXXXXX
X..............................................................................................................................................................................................................................................................................................................................................................................................................................................................................................................................X
X..............................................................................................................................................................................................................................................................................................................................................................................................................................................................................................................................X
X..............................................................................................................................................................................................................................................................................................................................................................................................................................................................................................................................X
X..............................................................................................................................................................................................................................................................................................................................................................................................................................................................................................................................X
X..............................................................................................................................................................................................................................................................................................................................................................................................................................................................................................................................X
X..............................................................................................................................................................................................................................................................................................................................................................................................................................................................................................................................X
X..............................................................................................................................................................................................................................................................................................................................................................................................................................................................................................................................X
X..............................................................................................................................................................................................................................................................................................................................................................................................................................................................................................................................X
X..................................................................................................................................................................................................................................................................................................................................................................................................................................................................G...........................................................X
X................................................................................................................................................................................................................................................................................................................................................................................................................................................................GGG...........................................................X
X..............................................................................................................................................................................................................................................................................................................................................................................................................................................................GGGGG...........................................................X
X................................................#####................................................................................................................................###################.......#########..............................#####.......................#########........##########...................................................................................................................................................GGG...........................................................X
X................................................#####................................................................................................................................###################.......#########..............................#####.......................#########........##########............................................................................................................................#######..................G...........................................................X
X................................................#####................................................................................................................................###################.......#########..............................#####.......................#########........##########............................................................................................................................#######..................G...........................................................X
X......................................................................................................................................................................................................................................................................................................................................................................................................................................##########..................G...........................................................X
X......................................................................................................................................................................................................................................................................................................................................................................................................................................##########..................G...........................................................X
X...................................................................................................................................................................................................................................................................................................................................................................................................................................#############..................G...........................................................X
X...................................................................................................................................................................................................................................................................................................................................................................................................................................#############..................G...........................................................X
X................................................................................................................................................................................................................................................................................................................................................................................................................................################..................G..........###..####........................................X
X................................................................................................................................................................................................................................................................................................................................................................................................................................################..................G..........#########........................................X
X..................................#####......############......................................................................................................................#######.............................#####...........#####.......#####........#####......................................................###....###........................###....###...........................##########.....................###################..................G..........#########........................................X
X..................................#####......############......................................................................................................................#######.............................#####...........#####.......#####........#####......................................................###....###........................###....###...........................##########.....................###################..................G..........#########........................................X
X..................................#####......############......................................................................................................................#######.............................#####...........#####.......#####........#####...................................................######....######..................######....######........................##########..................######################..................G.........###########.......................................X
X....................................................................................................................................................................................................................................................................................................................######....######..................######....######....................................................######################..................G........#############......................................X
X.................................................................................................................................................................................................................................................................................................................#########....#########............#########....#########..............................................#########################..................G........#####...#####......................................X
X.................................................................................................................................................................................................................................................................................................................#########....#########............#########....#########..............................................#########################................#####......####.....####......................................X
X..............................................................................................................................................................................................................................................................................................................############....############......############....############........................................############################................#####......###.......###......................................X
X..............................................................................................................................................................................................................................................................................................................############....############......############....############........................................############################................#####......###.......###......................................X
##############################################################################################################################################################....###################################......##################################################################################################################################################....##############################################################################################################################################################X
==============================================================================================================================================================....===================================......==================================================================================================================================================....==============================================================================================================================================================X
==============================================================================================================================================================....===================================......==================================================================================================================================================....==============================================================================================================================================================X
==============================================================================================================================================================....===================================......==================================================================================================================================================....==============================================================================================================================================================X
==============================================================================================================================================================....===================================......==================================================================================================================================================....==============================================================================================================================================================X
==============================================================================================================================================================....===================================......==================================================================================================================================================....==============================================================================================================================================================X
XXXXXXXXXXXXXXXXXXXXXXXXXXXXXXXXXXXXXXXXXXXXXXXXXXXXXXXXXXXXXXXXXXXXXXXXXXXXXXXXXXXXXXXXXXXXXXXXXXXXXXXXXXXXXXXXXXXXXXXXXXXXXXXXXXXX.XXXXXXXXXXXXXXXXXXXXXXXXXXXXXXXXXXXXXXXXXXXXXXXXXXXXXXXXXXXXXXXXXXXXXXXXXXXXXXXXXXXXXXXXXXXXXXXXXXXXXXXXXXXXXXXXXXXXXXXXXXXXXXXXXXXXXXXXXXXXXXXXXXXXXXXXXXXXXXXXXXXXXXXXXXXXXXXXXXXXXXXXXXXXXXXXXXXXXXXXXXXXXXXXXXXXXXXXXXXXXXXXXXXXXXXXXXXXXXXXXXXXXXXXXXXXXXXXXXXXXXXXXXXXXXXXXXXXXXXXXXXXXXXXXXXXXXXXXXXXXXXXXXXXXXXXXXXXXXXXXXXXXXXXXXXXXXXXXXXXXXXXXXXXXXXXXXXXXXXXXXXXXXXXXXXXXXXXXXX
