XXXXXXXXXXXXXXXXXXXXXXXXXXXXXXXXXXXXXXXXXXXXXXXXXXXXXXXXXXXXXXXXXXXXXXXXXXXXXXXXXXXXXXXXXXXXXXXXXXXXXXXXXXXXXXXXXXXXXXXXXXXXXXXXXXXXXXXXXXXXXXXXXXXXXXXXXXXXXXXXXXXXXXXXXXXXXXXXXXXXXXXXXXXXXXXXXXXXXXXXXXXXXXXXXXXXXXXXXXXXXXXXXXXXXXXXXXXXXXXXXXXXXXXXXXXXXXXXXXXXXXXXXXXXXXXXXXXXXXXXXXXXXXXXXXXXXXXXXXXXXXXXXXXXXXXXXXXXXXXXXXXXXXXXXXXXXXXXXXXXXXXXXXXXXXXXXXXXXXXXXXXXXXXXXXXXXXXXXXXXXXXXXXXXXXXXXXXXXXXXXXXXXXXXXXXXXXXXXXXXXXXXXXXXXXXXXXXXXXXXXXXXXXXXXXXXXXXXXXXXXXXXXXXXXXXXXXXXXXXXXXXXXXXXXXXXXXXXXXXXXXXXXXXXXXXX
X..............................................................................................................................................................................................................................................................................................................................................................................................................................................................................................................................X
X..............................................................................................................................................................................................................................................................................................................................................................................................................................................................................................................................X
X..............................................................................................................................................................................................................................................................................................................................................................................................................................................................................................................................X
X..............................................................................................................................................................................................................................................................................................................................................................................................................................................................................................................................X
X..............................................................................................................................................................................................................................................................................................................................................................................................................................................................................................................................X
X..............................................................................................................................................................................................................................................................................................................................................................................................................................................................................................................................X
X...................................................................................C...................................................................C............................................................................................................C.........................................................................................................................................................................................................................................................X
X....................................................................................................................................................................................................................................................................................................................................................................................................................................................................C...............................G.........................X
X....................................................................................................................................................................................................................................................................................................................................................................................................................................................................................................G.........................X
X....................................................................................................................................................................................................E............................E..............................................................................................................................................................................................................................................................g...G.........................X
X....................................................................................................................................................................................................................................................................................................................................................................................................................................................................................................G.........................X
X....................................................................................................................................................................................................................................................................................................................................................................................................................................................................................................G.........................X
X.................................................................................########..........................................................###############..............................###########......................##############.................###########................................................................................############.......................................................................................##############...........###..........G.........................X
X.................................................................................########..........................................................###############..............................###########......................##############.................###########................................................................................############.......................................................................................##############...........###..........G.........................X
X.................................................................................########..........................................................###############..............................###########......................##############.................###########................................................................................############.......................................................................................##############...........###..........G.........................X
X....................................................................................................................................................................................................................C..................................................................................................................................................................................................................................................................###..........G.........................X
X.......................................................................................................................................................................................................................................................................................................................................................................................................................................................................................###..........G.........................X
X.......................................................................................................................................................................................................................................................................................................................................................................................................................................................................................###..........G.........................X
X...................................................................####.............................................................................................................................................................................................................................................................................................................................................................................####...............................###..........G.........................X
X...................................................................####.............................................................................................................................................................................................................................................................................................................................................................................####...............................###..........G.........................X
X................................................................#######.......................####.................................................###############.........................................####################.............#########..................................................................................................................................................................................................................................###..........G.........................X
X................................................................#######.......................####.................................................###############.........................................####################.............#########..................................................................................................................................................................................................................................###..........G.........................X
X.............................................................##########.......................####.................................................###############.........................................####################.............#########.......................................................................................................................................................................................####.......................................###..........G.........................X
X.............................................................##########.......................####..........................................................................................................................................................................................................................................................................................................................................####.......................................###..........G.........................X
X..........................................................#############.......................#######.......................................................................................................................................................................................................................................................................................................................................####.......................................###..........G.........................X
X..........................................................#############.......................#######...................E.........................................E.....................................................E.....................................................................................................................E........................E....................................................................####...............E.......................###..........G.........................X
X.......................................................################.......................#######..........................................................................................................................................................................................................##############.......................................................######..................................................####.......................................###..........G.........................X
X.......................................................################.......................#######..........................................................................................................................................................................................................##############.......................................................######..................................................####.......................................###..........G.........................X
X################################################################################################################################################################################################################################################################...........############################........###########################################################################...........############################...........##################################################################################X
X================================================================================================================================================================================================================================================================...........============================........===========================================================================...........============================...........==================================================================================X
X================================================================================================================================================================================================================================================================...........============================........===========================================================================...........============================...........==================================================================================X
X================================================================================================================================================================================================================================================================...........============================........===========================================================================...........============================...........==================================================================================X
X================================================================================================================================================================================================================================================================...........============================........===========================================================================...........============================...........==================================================================================X
X================================================================================================================================================================================================================================================================...........============================........===========================================================================...........============================...........==================================================================================X
XXXXXXXXXXXXXXXXXXXXXXXXXXXXXXXXXXXXXXXXXXXXXXXXXXXXXXXXXXXXXXXXXXXXXXXXXXXXXXXXXXXXXXXXXXXXXXXXXXXXXXXXXXXXXXXXXXXXXXXXXXXXXXXXXXXXXXXXXXXXXXXXXXXXXXXXXXXXXXXXXXXXXXXXXXXXXXXXXXXXXXXXXXXXXXXXXXXXXXXXXXXXXXXXXXXXXXXXXXXXXXXXXXXXXXXXXXXXXXXXXXXXXXXXXXXXXXXXXXXXXXXXXXXXXXXXXXXXXXXXXXXXXXXXXXXXXXXXXXXXXXXXXXXXXXXXXXXXXXXXXXXXXXXXXXXXXXXXXXXXXXXXXXXXXXXXXXXXXXXXXXXXXXXXXXXXXXXXXXXXXXXXXXXXXXXXXXXXXXXXXXXXXXXXXXXXXXXXXXXXXXXXXXXXXXXXXXXXXXXXXXXXXXXXXXXXXXXXXXXXXXXXXXXXXXXXXXXXXXXXXXXXXXXXXXXXXXXXXXXXXXXXXXXXXXXX