XXXXXXXXXXXXXXXXXXXXXXXXXXXXXXXXXXXXXXXXXXXXXXXXXXXXXXXXXXXXXXXXXXXXXXXXXXXXXXXXXXXXXXXXXXXXXXXXXXXXXXXXXXXXXXXXXXXXXXXXXXXXXXXXXXXXXXXXXXXXXXXXXXXXXXXXXXXXXXXXXXXXXXXXXXXXXXXXXXXXXXXXXXXXXXXXXXXXXXXXXXXXXXXXXXXXXXXXXXXXXXXXXXXXXXXXXXXXXXXXXXXXXXXXXXXXXXXXXXXXXXXXXXXXXXXXXXXXXXXXXXXXXXXXXXXXXXXXXXXXXXXXXXXXXXXXXXXXXXXXXXXXXXXXXXXXXXXXXXXXXXXXXXXXXXXXXXXXXXXXXXXXXXXXXXXXXXXXXXXXXXXXXXXXXXXXXXXXXXXXXXXXXXXXXXXXXXXXXXXXXXXXXXXXXXXXXXXXXXXXXXXXXXXXXXXXXXXXXXXXXXXXXXXXXXXXXXXXXXXXXXXXXXXXXXXXXXXXXXXXXXXXXXXXXXXX
X..............................................................................................................................................................................................................................................................................................................................................................................................................................................................................................................................X
X..............................................................................................................................................................................................................................................................................................................................................................................................................................................................................................................................X
X..............................................................................................................................................................................................................................................................................................................................................................................................................................................................................................................................X
X..............................................................................................................................................................................................................................................................................................................................................................................................................................................................................................................................X
X..............................................................................................................................................................................................................................................................................................................................................................................................................................................................................................................................X
X..............................................................................................................................................................................................................................................................................................................................................................................................................................................................................................................................X
X..........................................................................................................................................................................................................................................................................................................................................................................................................................................................................##..##..##..##......................................X
X..........................................................................................................................................................................................................................................................................................................................................................................................................................................................................##..##..##..##......................................X
X..........................................................................................................................................................................................................................................................................................................................................................................................................................................................................##############......................................X
X.............................................................................................................................................................................................................................................................................................................................................................................................................................................G............................##############......................................X
X.............................................................................................................................................................................................................................................................................................................................................................................................................................................G............................######..######......................................X
X..........................................................................................................................................................................................................................E..............................................................................................................................................................................................................g...G............................#####....#####......................................X
X...............................................................................................................................................................................N.#######.....................................................................................................................................................................................................................................................G............................#####....#####......................................X
X............................................................................########.............................................................................................#######............................................................................................................................E.......................................................................................................#####............G...................##..###...###...###...###...###...###...###...###...###...###X
X............................................................................########...................................##############.M..........................................#######..............................####################.M................................................................................................................................................................................#####............G...................##..###...###...###...###...###...###...###...###...###...###X
X............................................................................########...................................##############............................................#######..............................####################............................................................................................................................C.....................................................#####............G...................#############################################################X
X.......................................................................................................................##############................C...........................#######...........#########..........####################....................................................................N.#################...................C.......................................................................#####............G...................#############################################################X
X.......................................................................................................................##############............................................#######...........#########..........####################.....................########.........................................#################......C..............................................................................###########............G...................###########..########..######################################X
X...............................................................................E......................###########......##############............................................#######...........#########..........####################.....................########...................E.....................#################.....................................................................................###########............G...................##########....######....#####################################X
X......................................................................................................###########......##############............................................#######...........#########..........####################.....................########.........................................#################.....................................................................................###########............G...................#########......####......####################################X
X......................................................................................................###########......##############...............#####........................#######...........#########..........####################.....................########.........................................#################.....................................................................................###########............G...................#########......####......####################################X
X.........................................................................################.............###########......##############...............#####........................#######...........#########..........####################.....................########..................############...........#################.....#####........#####.............#####......................................#################............G...................#########......####......####################################X
X.........................................................................################.............###########......##############...............#####........................#######...........#########..........####################.....................########..................############...........#################.....#####........#####.............#####......................................#################............G...................#############################################################X
X................................................................####.....################.............###########......##############...............#####........................#######...........#########..........####################.....................########..................############...........#################.....#####........#####.............#####......................................#################............G...................######..########..########..#################################X
X................................................................####.....################.............###########......##############...............#####........................#######...........#########..........####################.....................########..................############...........#################.....#####........#####.............#####......................................#################............G...................#####....######....######....################################X
X................................................................####.....################.............###########......##############...............#####........................#######...........#########..........####################.....................########..................############...........#################.....#####........#####.............#####.................E....................#################............G...................####......####......####......###############################X
X................................................................####.....################.............###########......##############...............#####........................#######...........#########..........####################.....................########..................############...........#################.....#####........#####.............#####......................................#################...........###..................####......####......####......###############################X
X.......................................................#####....####.....################.............###########......##############...............#####........................#######...........#########..........####################.....................########..................############...........#################.....#####........#####.............#####......................................#################...........###..................####......####......####......###############################X
X##############################################.........#####....####.....################.............###########......##############...............#####........................#######...........#########..........####################.....................########..................############...........#################.....#####........#####.............#####............########################################################################################################################################X
X==============================================.........#####....####.....################.............###########......##############...............#####........................#######...........#########..........####################.....................########..................############...........#################.....#####........#####.............#####............========================================================================================================================================X
X==============================================.........#####....####.....################.............###########......##############...............#####........................#######...........#########..........####################.....................########..................############...........#################.....#####........#####.............#####............========================================================================================================================================X
X==============================================.........#####....####.....################.............###########......##############...............#####........................#######...........#########..........####################.....................########..................############...........#################.....#####........#####.............#####............========================================================================================================================================X
X==============================================.........#####....####.....################.............###########......##############...............#####........................#######...........#########..........####################.....................########..................############...........#################.....#####........#####.............#####............========================================================================================================================================X
X==============================================.........#####....####.....################.............###########......##############...............#####........................#######...........#########..........####################.....................########..................############...........#################.....#####........#####.............#####............========================================================================================================================================X
XXXXXXXXXXXXXXXXXXXXXXXXXXXXXXXXXXXXXXXXXXXXXXXXXXXXXXXXXXXXXXXXXXXXXXXXXXXXXXXXXXXXXXXXXXXXXXXXXXXXXXXXXXXXXXXXXXXXXXXXXXXXXXXXXXXXXXXXXXXXXXXXXXXXXXXXXXXXXXXXXXXXXXXXXXXXXXXXXXXXXXXXXXXXXXXXXXXXXXXXXXXXXXXXXXXXXXXXXXXXXXXXXXXXXXXXXXXXXXXXXXXXXXXXXXXXXXXXXXXXXXXXXXXXXXXXXXXXXXXXXXXXXXXXXXXXXXXXXXXXXXXXXXXXXXXXXXXXXXXXXXXXXXXXXXXXXXXXXXXXXXXXXXXXXXXXXXXXXXXXXXXXXXXXXXXXXXXXXXXXXXXXXXXXXXXXXXXXXXXXXXXXXXXXXXXXXXXXXXXXXXXXXXXXXXXXXXXXXXXXXXXXXXXXXXXXXXXXXXXXXXXXXXXXXXXXXXXXXXXXXXXXXXXXXXXXXXXXXXXXXXXXXXXXXXXX