XXXXXXXXXXXXXXXXXXXXXXXXXXXXXXXXXXXXXXXXXXXXXXXXXXXXXXXXXXXXXXXXXXXXXXXXXXXXXXXXXXXXXXXXXXXXXXXXXXXXXXXXXXXXXXXXXXXXXXXXXXXXXXXXXXXXXXXXXXXXXXXXXXXXXXXXXXXXXXXXXXXXXXXXXXXXXXXXXXXXXXXXXXXXXXXXXXXXXXXXXXXXXXXXXXXXXXXXXXXXXXXXXXXXXXXXXXXXXXXXXXXXXXXXXXXXXXXXXXXXXXXXXXXXXXXXXXXXXXXXXXXXXXXXXXXXXXXXXXXXXXXXXXXXXXXXXXXXXXXXXXXXXXXXXXXXXXXXXXXXXXXXXXXXXXXXXXXXXXXXXXXXXXXXXXXXXXXXXXXXXXXXXXXXXXXXXXXXXXXXXXXXXXXXXXXXXXXXXXXXXXXXXXXXXXXXXXXXXXXXXXXXXXXXXXXXXXXXXXXXXXXXXXXXXXXXXXXXXXXXXXXXXXXXXXXXXXXXXXXXXXXXXXXXXXXX
X..............................................................................................................................................................................................................................................................................................................................................................................................................................................................................................................................X
X..............................................................................................................................................................................................................................................................................................................................................................................................................................................................................................................................X
X..............................................................................................................................................................................................................................................................................................................................................................................................................................................................................................................................X
X..............................................................................................................................................................................................................................................................................................................................................................................................................................................................................................................................X
X..............................................................................................................................................................................................................................................................................................................................................................................................................................................................................................................................X
X..............................................................................................................................................................................................................................................................................................................................................................................................................................................................................................................................X
X..........................................................................................................................................................................................................................................................................................................................................................................................................................................................................##..##..##..##......................................X
X..........................................................................................................................................................................................................................................................................................................................................................................................................................................................................##..##..##..##......................................X
X..........................................................................................................................................................................................................................................................................................................................................................................................................................................................................##############......................................X
X....................................................................................................................................................................................................................................................................................................................................................................................................................................................G.....................##############......................................X
X....................................................................................................................................................................................................................................................................................................................................................................................................................................................G.....................######..######......................................X
X................................................................................................................................................................................................................................................................................................................................................................................................................................................g...G.....................#####....#####......................................X
X...............................................................................................................................................................................N.#####..............................................................................................................................................................................................................................................................G.....................#####....#####......................................X
X.................................................................................................................................................................................#####......................................................................................................................................................................................................................................#####...................G............##..###...###...###...###...###...###...###...###...###...###X
X.......................................................................................................................##############.M..........................................#####.........................................###########.M................................................................................................................................................................................#####...................G............##..###...###...###...###...###...###...###...###...###...###X
X............................................................................########...................................##############............................................#####.........................................###########..................................................................................................................................................................................#####...................G............#############################################################X
X............................................................................########...................................##############............................................#####..........#######........................###########....................................................................N.#################...........................................................................................#####...................G............#############################################################X
X............................................................................########...................................##############............................................#####..........#######........................###########......................................................................#################.....................................................................................###########...................G............###########..########..######################################X
X......................................................................................................###########......##############............................................#####..........#######.........#####..........###########......................................................................#################.....................................................................................###########...................G............##########....######....#####################################X
X......................................................................................................###########......##############............................................#####..........#######.........#####..........###########......................................................................#################.....................................................................................###########...................G............#########......####......####################################X
X......................................................................................................###########......##############...............#####........................#####..........#######.........#####..........###########......................................................................#################.....................................................................................###########...................G............#########......####......####################################X
X.........................................................................################.............###########......##############...............#####........................#####..........#######.........#####..........###########......................................................................#################..................#####.............#####......................................#################...................G............#########......####......####################################X
X.........................................................................################.............###########......##############...............#####........................#####..........#######.........#####..........###########......................................................................#################..................#####.............#####......................................#################...................G............#############################################################X
X................................................................####.....################.............###########......##############...............#####........................#####..........#######.........#####..........###########......................................................................#################..................#####.............#####......................................#################...................G............######..########..########..#################################X
X................................................................####.....################.............###########......##############...............#####........................#####..........#######.........#####..........###########......................................................................#################..................#####.............#####......................................#################...................G............#####....######....######....################################X
X................................................................####.....################.............###########......##############...............#####........................#####..........#######.........#####..........###########.....................................................#####............#################..................#####.............#####......................................#################...................G............####......####......####......###############################X
X................................................................####.....################.............###########......##############...............#####........................#####..........#######.........#####..........###########.....................................................#####............#################..................#####.............#####......................................#################..................###...........####......####......####......###############################X
X.......................................................#####....####.....################......####...###########......##############...............#####........................#####..........#######.........#####..........###########.....................................................#####............#################..................#####.............#####......................................#################..................###...........####......####......####......###############################X
X##############################################.........#####....####.....################......####...###########......##############...............#####........................#####..........#######.........#####..........###########.....................................................#####............#################..................#####.............#####............#######################.################################################################################################################X
X==============================================.........#####....####.....################......####...###########......##############...............#####........................#####..........#######.........#####..........###########.....................................................#####............#################........#####.....#####.............#####............========================================================================================================================================X
X==============================================.........#####....####.....################......####...###########......##############...............#####........................#####..........#######.........#####..........###########.....................................................#####............#################........#####.....#####.............#####............========================================================================================================================================X
X==============================================.........#####....####.....################......####...###########......##############...............#####........................#####..........#######.........#####..........###########.....................................................#####............#################........#####.....#####.............#####............========================================================================================================================================X
X==============================================.........#####....####.....################......####...###########......##############...............#####........................#####..........#######.........#####..........###########.....................................................#####............#################........#####.....#####.............#####............========================================================================================================================================X
X==============================================.........#####....####.....################......####...###########......##############...............#####........................#####..........#######.........#####..........###########.....................................................#####............#################........#####.....#####.............#####............========================================================================================================================================X
XXXXXXXXXXXXXXXXXXXXXXXXXXXXXXXXXXXXXXXXXXXXXXXXXXXXXXXXXXXXXXXXXXXXXXXXXXXXXXXXXXXXXXXXXXXXXXXXXXXXXXXXXXXXXXXXXXXXXXXXXXXXXXXXXXXXXXXXXXXXXXXXXXXXXXXXXXXXXXXXXXXXXXXXXXXXXXXXXXXXXXXXXXXXXXXXXXXXXXXXXXXXXXXXXXXXXXXXXXXXXXXXXXXXXXXXXXXXXXXXXXXXXXXXXXXXXXXXXXXXXXXXXXXXXXXXXXXXXXXXXXXXXXXXXXXXXXXXXXXXXXXXXXXXXXXXXXXXXXXXXXXXXXXXXXXXXXXXXXXXXXXXXXXXXXXXXXXXXXXXXXXXXXXXXXXXXXXXXXXXXXXXXXXXXXXXXXXXXXXXXXXXXXXXXXXXXXXXXXXXXXXXXXXXXXXXXXXXXXXXXXXXXXXXXXXXXXXXXXXXXXXXXXXXXXXXXXXXXXXXXXXXXXXXXXXXXXXXXXXXXXXXXXXXXXXX